border_size=1
usage=map

Mm^Xm       , Mm^Xm       , Mm^Xm       , Mm^Xm       , Mm^Xm       , Mm          , Hh          , Hh          , Rr          , Rr          , Rr          , Rr          , Rr          , Rr          , Rr          , Rr          , Rr          , Hh          , Hh          , Mm          , Mm          , Mm^Xm       , Mm^Xm       , Mm          , Mm^Xm       , Mm^Xm       , Mm^Xm       
Mm^Xm       , Mm^Xm       , Mm^Xm       , Mm^Xm       , Mm^Xm       , Mm          , Hh          , Hh          , Rr          , Rr          , Gg^Vh       , Rr          , Rr          , Rr          , Gg^Vh       , Rr          , Rr          , Hh          , Hh          , Mm          , Mm          , Mm^Xm       , Mm^Xm       , Mm          , Mm^Xm       , Mm^Xm       , Mm^Xm       
Mm^Xm       , Mm^Xm       , Mm^Xm       , Mm^Xm       , Mm          , Mm          , Hh          , Hh          , Rr          , Rr          , Gg          , Rr          , Rr          , Rr          , Gg          , Rr          , Rr          , Rr          , Hh          , Mm          , Mm          , Mm^Xm       , Mm^Xm       , Mm^Xm       , Mm^Xm       , Mm^Xm       , Mm^Xm       
Mm^Xm       , Mm^Xm       , Mm          , Mm          , Mm          , Mm          , Hh          , Rr          , Rr          , Rr          , Gg^Vh       , Rr          , Rr          , Rr          , Gg^Vh       , Rr          , Rr          , Rr          , Rr          , Hh          , Hh          , Mm          , Mm^Xm       , Mm^Xm       , Mm^Xm       , Mm^Xm       , Mm^Xm       
Mm          , Mm          , Hh          , Gs^Fp       , Hh          , Hh          , Rr          , Rr          , Rr          , Rr          , Rr          , Rr          , Rr          , Rr          , Rr          , Rr          , Rr          , Rr          , Rr          , Hh          , Hh          , Mm          , Mm^Xm       , Mm^Xm       , Mm^Xm       , Mm^Xm       , Mm^Xm       
Hh          , Hh          , Rr          , Rr          , Rr          , Rr          , Rr          , Rr          , Gg          , Rr          , Rr          , Rr          , Rr          , Rr          , Rr          , Rr          , Rr          , Rr          , Rr          , Rr          , Rr          , Hh          , Mm          , Mm^Xm       , Mm^Xm       , Mm^Xm       , Mm^Xm       
Rr          , Rr          , Rr          , Rr          , Rr          , Rr          , Gg          , Gs^Fp       , Gg          , Rr          , Rr          , Rr          , Rr          , Rr          , Xu          , Rr          , Gg^Vh       , Rr          , Rr          , Rr          , Rr          , Hh          , Hh          , Mm          , Mm          , Mm^Xm       , Mm^Xm       
Rr          , Rr          , Rr          , Rr          , Rr          , Rr          , Rr          , Gg          , Rr          , Rr          , Rr          , Rr          , Xu          , Xu          , Ch          , Xu          , Xu          , Gg          , Gg          , Rr          , Rr          , Rr          , Rr          , Hh          , Hh          , Mm          , Mm          
Rr          , Rr          , Rr          , Rr          , Rr          , Rr          , Rr          , Rr          , Rr          , Rr          , Xu          , Xu          , Rr          , Ch          , 3 Kh        , Ch          , Rr          , Xu          , Xu          , Gg^Vh       , Gg          , Rr          , Rr          , Rr          , Rr          , Hh          , Hh          
Rr          , Rr          , Rr          , Rr          , Rr          , Rr          , Rr          , Rr          , Xu          , Xu          , Rr          , Rr          , Rr          , Ch          , Ch          , Ch          , Rr          , Rr          , Rr          , Xu          , Xu          , Gg          , Gg          , Rr          , Rr          , Rr          , Rr          
Rr          , Rr          , Ss^Vhs      , Rr          , Ss^Vhs      , Rr          , Xu          , Xu          , Rr          , Rr          , Rr          , Rr          , Rr          , Rr          , Rr          , Rr          , Rr          , Rr          , Rr          , Rr          , Gs^Fp       , Xu          , Gs^Ft       , Gg^Vh       , Xu          , Rr          , Rr          
Rr          , Rr          , Ss          , Ss          , Ss          , Rr          , Xu          , Gs^Fp       , Rr          , Rr          , Rr          , Rr          , Rr          , Rr          , Rr          , Rr          , Rr          , Rr          , Rr          , Rr          , Rr          , Xu          , Xu          , Xu          , Rr          , Xu          , Xu          
Rr          , Rr          , Ss^Vhs      , Rr          , Ss          , Rr          , Xu          , Rr          , Rr          , Rr          , Rr          , Rr          , Rr          , Rr          , Rr          , Rr          , Rr          , Rr          , Rr          , Rr          , Rr          , Xu          , Rr          , Rr          , Rr          , Rr          , Rr          
Rr          , Rr          , Ss          , Ss          , Ss^Vhs      , Rr          , Xu          , Rr          , Rr          , Rr          , Rr          , Rr          , Rr          , Rr          , Rr          , Rr          , Rr          , Rr          , Rr          , Rr          , Rr          , Rr          , Rr          , Rr          , 1 Kh        , Rr          , Rr          
Rr          , Rr          , Ss          , Ss          , Ss          , Rr          , Xu          , Rr          , Rr          , Rr          , Rr          , Rr          , Rr          , Rr          , Rr          , Rr          , Rr          , Rr          , Rr          , Rr          , Rr          , Rr          , Rr          , Rr          , Rr          , Rr          , Rr          
Rr          , Rr          , Ss^Vhs      , Ss          , Ss^Vhs      , Rr          , Xu          , Rr          , Rr          , Rr          , Rr          , Rr          , Rr          , Rr          , Rr          , Rr          , Rr          , Rr          , Rr          , Rr          , Rr          , Xu          , Xu          , Rr          , Rr          , Rr          , Rr          
Rr          , Rr          , Ss          , Ss          , Rr          , Rr          , Xu          , Rr          , Ch          , Ch          , Ch          , Rr          , Rr          , Rr          , Rr          , Rr          , Rr          , Rr          , Rr          , Rr          , Rr          , Xu          , Gs^Ft       , Xu          , Xu          , Xu          , Xu          
Rr          , Rr          , Rr          , Rr          , Rr          , Rr          , Xu          , Ch          , Ch          , 2 Kh        , Ch          , Rr          , Rr          , Rr          , Rr          , Rr          , Rr          , Rr          , Rr          , Rr          , Gs^Fp       , Xu          , Gs^Ft       , Gs^Ft       , Rr          , Rr          , Rr          
Rr          , Rr          , Rr          , Rr          , Rr          , Rr          , Gg^Vh       , Xu          , Xu          , Ch          , Ch          , Rr          , Rr          , Rr          , Rr          , Rr          , Rr          , Rr          , Rr          , Rr          , Xu          , Xu          , Rr          , Rr          , Rr          , Rr          , Rr          
Hh          , Hh          , Hh          , Rr          , Rr          , Rr          , Rr          , Gg          , Gg          , Xu          , Xu          , Rr          , Rr          , Rr          , Rr          , Rr          , Rr          , Rr          , Xu          , Xu          , Gg          , Gg^Vh       , Rr          , Rr          , Rr          , Rr          , Rr          
Mm          , Mm          , Mm          , Hh^Vhh      , Hh          , Rr          , Rr          , Rr          , Rr          , Gg^Vh       , Gg          , Xu          , Xu          , Rr          , Gs^Fp       , Rr          , Xu          , Xu          , Gg          , Gg^Vh       , Rr          , Rr          , Gg^Vh       , Rr          , Rr          , Rr          , Rr          
Mm^Xm       , Mm^Xm       , Mm^Xm       , Mm          , Mm          , Hh          , Hh^Vhh      , Rr          , Rr          , Rr          , Rr          , Gg          , Gg^Vh       , Xu          , Xu          , Xu          , Gg^Vh       , Gg          , Rr          , Rr          , Gg^Vh       , Gg^Vh       , Gg          , Gg          , Rr          , Rr          , Rr          
Mm^Xm       , Mm^Xm       , Mm^Xm       , Mm^Xm       , Mm^Xm       , Mm          , Mm          , Hh          , Hh          , Rr          , Rr          , Rr          , Rr          , Gg          , Gg^Vh       , Gg          , Rr          , Rr          , Gg^Vh       , Gg^Vh       , Gg          , Gg          , Gg^Vh       , Gg^Vh       , Rr          , Rr          , Rr          
Mm^Xm       , Mm^Xm       , Mm^Xm       , Mm^Xm       , Mm^Xm       , Mm^Xm       , Mm^Xm       , Mm          , Mm          , Hh^Vhh      , Hh          , Rr          , Rr          , Rr          , Rr          , Rr          , Rr          , Rr          , Gg          , Gg          , Gg^Vh       , Gg^Vh       , Rr          , Rr          , Gg^Vh       , Gg          , Gg          
Mm^Xm       , Mm^Xm       , Mm^Xm       , Mm^Xm       , Mm^Xm       , Mm^Xm       , Mm^Xm       , Mm^Xm       , Mm^Xm       , Mm          , Mm          , Hh          , Hh          , Rr          , Rr          , Rr          , Ss          , Rr          , Rr          , Gg^Vh       , Rr          , Rr          , Gg^Vh       , Gg^Vh       , Gg          , Gg          , Gg          
Mm^Xm       , Mm^Xm       , Mm^Xm       , Mm^Xm       , Mm^Xm       , Mm^Xm       , Mm^Xm       , Mm^Xm       , Mm^Xm       , Mm          , Mm          , Hh          , Hh          , Rr          , Rr          , Ss^Vhs      , Ss          , Rr          , Rr          , Rr          , Rr          , Gg^Vh       , Gg          , Gg          , Gg          , Hh          , Hh          
Mm^Xm       , Mm^Xm       , Mm^Xm       , Mm^Xm       , Mm^Xm       , Mm^Xm       , Mm^Xm       , Mm^Xm       , Mm^Xm       , Mm          , Mm          , Hh          , Hh          , Rr          , Rr          , Ss          , Ss          , Rr          , Rr          , Rr          , Rr          , Rr          , Gg          , Gg          , Gg          , Hh          , Hh          
